{
	"TileWidth": 15,
	"TileHeight": 15,
	"MapWidth": 20,
	"MapHeight": 20,
	"MapSource": "../images/basic_map.png",

	
	"Walkable": [
		[1,1,1,1,1,1,1,1,1,1,1,1,1,1,1,1,1,1,1,1],
		[1,0,0,0,0,0,0,0,0,0,0,0,0,0,0,0,0,0,0,1],
		[1,0,0,0,0,0,0,0,1,0,0,0,0,0,0,0,0,0,0,1],
		[1,0,0,0,0,0,0,0,1,0,0,0,0,0,0,0,0,0,0,1],
		[1,0,0,0,0,0,0,0,1,0,0,0,0,0,0,0,0,0,0,1],
		[1,0,0,0,0,0,0,0,1,0,0,0,0,0,0,0,0,0,0,1],
		[1,1,1,1,1,1,1,1,1,0,0,0,0,0,0,0,0,0,0,1],
		[1,0,0,0,0,0,0,0,0,0,0,0,0,0,0,0,0,0,0,1],
		[1,0,0,0,0,0,0,0,0,0,0,0,0,0,0,0,0,0,0,1],
		[1,0,0,0,0,0,0,0,0,0,0,0,0,0,0,1,1,1,1,1],
		[1,0,0,0,0,0,0,0,0,0,0,0,0,0,0,1,0,0,0,1],
		[1,0,0,0,0,0,0,0,0,0,0,0,0,1,1,1,0,0,0,1],
		[1,0,0,1,1,1,1,1,1,0,0,0,0,1,0,0,0,0,0,1],
		[1,0,0,0,0,1,0,0,0,0,0,0,0,1,0,0,0,0,0,1],
		[1,0,0,0,0,1,0,0,0,0,0,0,0,0,0,0,0,0,0,1],
		[1,0,0,0,0,1,0,0,0,0,0,0,0,1,1,1,1,1,1,1],
		[1,0,0,0,0,1,0,0,0,0,0,0,0,0,0,0,0,0,0,1],
		[1,0,0,0,0,1,0,0,0,0,0,0,0,0,0,0,0,0,0,1],
		[1,0,0,0,0,1,0,0,0,0,0,0,0,0,0,0,0,0,0,1],
		[1,1,1,1,1,1,1,1,1,1,1,1,1,1,1,1,1,1,1,1]
	],
	
	"TerrainLayer": [
		[1,1,1,1,1,1,1,1,1,1,1,1,1,1,1,1,1,1,1,1],
		[1,0,0,0,0,0,0,0,0,0,0,0,0,0,0,0,0,0,0,1],
		[1,0,0,0,0,0,0,0,1,0,0,0,0,0,0,0,0,0,0,1],
		[1,0,0,0,0,0,0,0,1,0,0,0,0,0,0,0,0,0,0,1],
		[1,0,0,0,0,0,0,0,1,0,0,0,0,0,0,0,0,0,0,1],
		[1,0,0,0,0,0,0,0,1,0,0,0,0,0,0,0,0,0,0,1],
		[1,1,1,1,1,1,1,1,1,0,0,0,0,0,0,0,0,0,0,1],
		[1,0,0,0,0,0,0,0,0,0,0,0,0,0,0,0,0,0,0,1],
		[1,0,0,0,0,0,0,0,0,0,0,0,0,0,0,0,0,0,0,1],
		[1,0,0,0,0,0,0,0,0,0,0,0,0,0,0,1,1,1,1,1],
		[1,0,0,0,0,0,0,0,0,0,0,0,0,0,0,1,0,0,0,1],
		[1,0,0,0,0,0,0,0,0,0,0,0,0,1,1,1,0,0,0,1],
		[1,0,0,1,1,1,1,1,1,0,0,0,0,1,0,0,0,0,0,1],
		[1,0,0,0,0,1,0,0,0,0,0,0,0,1,0,0,0,0,0,1],
		[1,0,0,0,0,1,0,0,0,0,0,0,0,0,0,0,0,0,0,1],
		[1,0,0,0,0,1,0,0,0,0,0,0,0,1,1,1,1,1,1,1],
		[1,0,0,0,0,1,0,0,0,0,0,0,0,0,0,0,0,0,0,1],
		[1,0,0,0,0,1,0,0,0,0,0,0,0,0,0,0,0,0,0,1],
		[1,0,0,0,0,1,0,0,0,0,0,0,0,0,0,0,0,0,0,1],
		[1,1,1,1,1,1,1,1,1,1,1,1,1,1,1,1,1,1,1,1]
	]
	
}